R        1000   450
NO              ./textures/golden.xpm
SO    ./textures/son2.xpm
WE     ./textures/son3.xpm
EA      ./textures/green.xpm
S        ./textures/sonic.xpm
F     ./textures/son4.xpm
C ./textures/sky2.xpm



 1
  1111111111111111111111111111111111111111111111111111
 10000000000000200000000000000000000001
 1000000000000000000000000000000000001
 10000000000000E00000000200000000000001
 10000000000000000000000000020000000000111
 100001111111111111111111111111111111100001
 100001                              100001
 100001     111111                   100001
 100001        111                   100001
 100001      111                     100001
 100001     111111           11      100001
 100001                      11      100001 
 100001                      11      100001
 100001                      11      100001
 100001                              100001
 100001111111111111111111111111111111100001
 100000000000000000000000000000000000000001
 111111111111111111111111111111111111111111