R        1010   1010
NO./textures/ai.xpm
SO./././textures/picture_sunrise.xpm
WE     textures/picture_dawn.xpm

EA      textures/picture_cloud.xpm

S        textures/spiral.xpm

F       33 ,   68 ,     25

C  52  ,    1,    88


 1
  1111111111111111111111111111111111111111111111111111
 10000000000000200000000000000000000001
 1000020000000000000000000000000000001
 10000000002000E00000000000000200000201
 10000000000000000000000000000000000000111
 100001111111111111111111111111111111100001
 100001                              100001
 100001                              100001
 100001                              100001
 100001                              100001
 100001                              100001
 100001                              100001 
 100001                              100001
 100001                              100001
 100001                              100001
 100001111111111111111111111111111111100001
 100000000000000000000000000000000000000001
 111111111111111111111111111111111111111111