R 1536 864

NO ./res/xpm/walls/256/brick_wall_texture.xpm
SO ./res/xpm/walls/256/wall_grey_rock.xpm
WE ./res/xpm/walls/256/wall_brown_tiles.xpm
EA ./res/xpm/walls/256/wall_white_rock.xpm
S  ./res/xpm/sprites/r2d2.xpm

F	61,		43,		31
C	00,		51,		102

                                         11111111111111111
       11111111111111111              11110000000000110201
  1111100000000000000001              10000000000000110001
  1020000011111111100111              10000011111000110001
  10000000000000000021                10000000001000000001
  10011111111111111111                10000111001200000201
  101                                 11111  1001111111111
  101                                        1001
  101   11111111111111111111111111111111111111001
  10111110000000000000110000200000000000000000001
  10000000110000000200110000000000000000000000001
  11111110110000200001110000002000000020000111111
        100100000000000000000000000000000001
111111111011E0000000011100000000000000000001
10000000001100000000011101111101111111111111      111111
111101111111111111011100000010001                 100201
11110111111111111101110101001000111111111111111111100001
11000000110101111101110000001000000000000000000000000001
1000200000000000000011000000100011111100000000001100201
100000000000000000001101010010001    111111100001100001
11000001110101111101111101111000111        100000000001
11110111 11101111101 101111010001          111111111111
11111111 11111111111 111111111111