R        100000  4500

NO./res/rap1.xpm
SO./././res/rap2.xpm
WE     res/rap3.xpm

EA      res/rap5.xpm

S        res/rap.xpm

F       24,   18 ,     14

C  ./res/night_sky.xpm

                11111111111
               1000020200001
 1     1       1000000000001
 1    121      1111110111111
 1   10001     1000000000001
 1   10101     1000000000001
 1   10121      1000000000001
  1110011111111111111011111111111111111111111111111111
 112100000001002100000000201000020000000000000001
 110002000001000100000000001000000000111111110001
 1200000000210E0000000000021000000002011 11111001
 111000000001000000002000000000000000000111 110011
 1000010011111111101111111110111100111000011100001
 1000010000000000000000200010000100000000000000001
 1001111100000000100000000001000010001000011100021
 1000000200000111100001111000000001000000011111111
 100001000000000012000100100001000000000001
 102001100000002010000100100000100001100001
 100001110111000010000110100001000000100001
 100001020001200010000000000010001002100201
 10000100000100001111111200100011100100001
 100001000000000000000000001000111110000001
 100001111111111111111111000011111111000001
 100000000000000000000000000000000000000001
 111111111111111111111111111111111111111111