R 800 600

NO ./res/wall.xpm
SO ./res/grass.xpm
WE ./res/brick.xpm
EA ./res/wood.xpm
S ./res/sprite.xpm

C 125,255,255
F 120,15,150

111111
100101
102001
1100N1
111111
