R 800 600

NO ./res/drawing.xpm
SO ./res/green.xpm
WE ./res/illusion.xpm
EA ./res/rap.xpm
S ./res/sonic.xpm

C 125,255,255
F 120,15,150

111111
100101
102001
1100N1
111111