R        1500   1500
NO./res/ai.xpm
SO./././res/picture_sunrise.xpm
WE     res/picture_dawn.xpm

EA      res/picture_cloud.xpm

S        res/golden.xpm

F res/picture_cloud.xpm

C 0  ,    1,    88


 1
  1111111111111111111111111111111111111111111111111111
 110000000000002000000000200000000000000000000001
 100002000000000000000200000000000000111111110001
 1000000000200E0000000000000002000002011 11111001
 100000000000000000002000000000000000000111 110011
 1000011111111111101111111110111100111000011100001
 1000010000000000100000000010000100000000000000001
 1000010000000000100000000001000010001000011100001
 1000010000000111100001111000000001000000011111111
 1000010000000000100001  100001000010000001
 1000010000010000100001  100000100001100001
 100001111111000010000111100001010000100001
 100001000001000010000000000010001000100001
 100001000001000011111100000100011100100001
 100001000000000000000000001000111110100001
 100001111111111111111111110111111111100001
 100000000000000000000000000000000000000001
 111111111111111111111111111111111111111111