R        1500   1500
NO./res/rap1.xpm
SO./././res/rap2.xpm
WE     some/rap3.xpm

EA      res/rap5.xpm

S        res/rap.xpm

F       30 ,   30 ,     10

C  52  ,    1,    88

                11111111111
               1000200020001
 1             1000000000001
 1             1000000000001
 1             1000000000001
 1             1000000000001
 1             1000000000001
  1111111111111111111011111111111111111111111111111111
 11000000000000000000000000000000000000000000000000001
 11000000000000200000000000000000000000000000000200001
 1000000000000000000000000000000000000000000000000001
 1000000000000000000000000000000000000000000000000001
 1000000000000000000000000000000000000000000000000001
 1000000000000000000000000000000000000000000000000001
 1000000000000000000000000000000000000000000000000001
 1000000000000000000000000000000000000000000000000001
 1000000000000000000000000000000000000000000000000001
 1000000000000000000000002N00000000000000000000000001
 1000000000000000000000000000000000000000000000000001
 1000000000000000000000000000000000000000000000000001
 1000000000000000000000000000000000000000000000000001
 1000000000000000000000000000000000000000000000000001
 1000000000000000000000000000000000000000000000000001
 1000000000000000000000000000000000000000000000000001
 1000000000000000000000000000000000000000000000000001
 1000000000000000000000000000000000000000000000000001
 1111111111111111111111111111111111111111111111111111