R        1700   1700
NO    ./textures/son3.xpm
SO    ./textures/son2.xpm
WE      ./textures/son1.xpm
EA       ./textures/son4.xpm
S        ./textures/sonic.xpm
F       42,   212,     39
C  190  ,    238,    239


 1
  111111111111111111111111111111111111
 10000020000000000000111201000010000001
 10000000000000200000000001000010002001
 10000000000000N000000000000000100000001
 10000200000000000000002000000000000000111
 10000001111111011111101111111111111100001
 100001000000000000000000000000000000100001
 100001111111111110000000000000000000100001
 100001    1   1110000000000000000000100001
 100001      111000000000000011000000100001
 100001     1111111111111111111111111100001
 100001                  1   11      100001
 100001                      11      100001
 100001                      11      100001
 100001                              100001
 100001111111111111111111111111111111100001
 100000000000000000000000000000000000000001
 111111111111111111111111111111111111111111